00 00 00 0 0 0 0 0 00 0 0 0 00 00 00 00 00 00 00 00 00 00 00 00 0 0 00 00 00 00 00 00 0 0 0 0 00 00 0 0 0 00 00 00 00 00 00 00 00 00 00 00 0 0 0 00 00 00 00 00 00 00 0 00 00 0 00 00 00 00 0 0 00 0 0 07 8 8 08 08 08 08 08 08 08 8 8 8 08 08 08 08 08 08 08 08 08 8 8 08 08 08 8 8 08 08 08 08 8 8 8 9 00 0 0 00 0 0 00 0 0 00 0 00 00 00 00 0 00 0 0 00 0 0 0 00 0 0 0 00 0 0 0 0 0 0 0 00 00 00 00 0 4 5 5 5 5 05 05 5 5 05 08 08 05 5 5 05 05 5 5 8 8 8 08 08 08 08 8 8 9 0 0 0 00 00 0 00 0 0 0 00 00 0 0 00 00 0 00 00 00 0 0 0 0 0 0 00 00 0 00 00 0 0 00 00 0 0 00 00 0 0 00 00 0 0 00 00 0 0 00 00 0 0 00 00 0 0 00 00 0 0 00 00 0 0 0 0 00 00 00 00 00 00 0 0 0 0 0 0 00 00 00 00 00 00 00 00 00 0 0 0 0 0 0 00 00 00 00 00 00 0 0 0 00 00 0 0 0 00 00 0 4 06 00 00 00 00 00 00 00 00 00 0 0 0 0 00 00 00 00 00 00 00 0 0 00 00 00 00 00 00 00 0 00 00 0 0 0 0 00 0 0 00 00 00 00 0 0 00 0 0 0 0 0 0 0 0 0 00 00 00 00 00 00 00 00 00 00 00 00 00 00 00 00 00 00 0 00 00 00 00 00 00 00 00 00 00 00 00 00 00 00 0 0 0 0 0 0 0 0 0 0 0 0 0 00 00 00 00
00 00 00 0 0 0 0 0 00 0 0 0 00 00 24 24 25 25 24 24 00 00 00 00 0 0 00 00 00 00 00 00 0 0 0 0 00 00 0 0 0 00 00 00 00 00 00 00 24 24 24 00 0 0 0 00 24 24 24 00 00 00 0 00 00 0 00 00 00 00 0 0 00 0 0 00 0 0 00 00 00 00 00 00 00 0 0 0 24 24 24 24 00 00 00 00 00 0 0 24 24 24 0 0 00 00 00 00 0 0 0 0 00 0 0 00 0 0 00 0 0 00 0 24 24 00 00 0 00 0 0 00 0 0 0 00 0 0 0 00 0 0 0 0 0 0 0 00 00 00 00 0 4 5 5 5 5 05 05 5 5 06 24 00 07 8 8 08 08 8 9 0 0 0 00 00 00 00 0 0 0 0 0 0 24 24 0 00 0 0 0 00 00 0 0 00 00 0 00 00 00 0 0 0 0 0 0 00 00 0 00 00 0 0 00 00 0 0 00 00 0 0 00 00 0 0 00 00 0 0 00 00 0 0 00 00 0 0 00 00 0 0 00 00 0 0 0 0 00 24 24 24 24 00 0 0 0 0 0 0 00 00 00 24 25 24 00 00 00 0 0 0 0 0 0 00 24 24 24 24 00 0 0 0 00 00 0 0 0 00 00 0 4 06 00 00 24 00 00 00 00 00 00 0 0 0 0 00 00 00 24 00 24 00 0 0 00 24 00 24 00 00 00 0 00 00 0 0 0 0 00 0 0 00 00 00 00 0 0 00 0 0 0 0 0 0 0 0 0 00 00 00 00 00 00 00 00 00 00 00 00 00 00 00 00 00 00 0 00 00 00 00 00 00 00 00 00 00 00 00 00 00 00 0 0 0 0 0 0 0 0 0 0 0 0 0 00 00 00 00
00 00 00 0 0 0 0 0 00 0 0 0 00 00 00 24 24 24 24 00 00 00 00 00 0 0 24 24 24 24 24 24 0 0 0 0 00 00 0 0 0 00 00 00 00 00 00 25 24 24 24 25 0 0 0 25 24 24 24 25 00 00 0 00 00 0 00 00 00 00 0 0 00 0 0 00 0 0 00 00 00 00 00 00 00 0 0 0 00 00 00 00 00 00 00 00 00 0 0 24 24 24 0 0 00 00 00 00 0 0 0 0 00 0 0 00 0 0 00 0 0 24 0 00 24 24 00 0 00 0 0 00 0 0 0 00 0 0 0 00 0 0 0 0 0 0 0 00 00 00 00 0 7 8 8 8 8 08 08 8 5 06 24 25 00 0 0 00 00 0 0 0 0 0 00 00 00 00 0 0 0 0 0 0 24 24 0 00 0 0 0 00 00 0 0 00 00 0 00 00 00 0 0 0 0 0 0 00 00 0 00 00 0 0 00 00 0 0 00 00 0 0 00 00 0 0 00 00 0 0 00 00 0 0 00 00 0 0 00 00 0 0 00 00 0 0 0 0 00 24 24 24 24 00 0 0 0 0 0 0 00 00 24 24 00 24 24 00 00 0 0 0 0 0 0 00 24 24 24 24 00 0 0 0 00 00 0 0 0 00 00 0 4 06 00 24 26 24 00 00 00 00 00 0 0 0 0 00 00 24 24 24 24 24 0 0 24 24 24 24 24 00 00 0 00 00 0 0 0 0 00 0 0 00 00 00 00 0 0 00 0 0 0 0 0 0 0 0 0 00 00 00 00 00 00 00 00 00 00 00 00 00 00 00 00 00 00 0 00 00 25 00 25 00 25 25 25 00 25 00 25 00 00 0 0 0 0 0 0 0 0 0 0 0 0 0 00 00 00 00
00 00 00 0 0 0 0 0 00 0 0 0 00 00 00 00 00 00 00 00 00 00 00 00 0 0 00 00 00 00 00 00 0 0 0 0 00 00 0 0 0 00 00 00 00 00 00 00 00 00 00 00 0 0 0 00 00 00 00 00 00 00 0 00 00 0 00 00 00 00 0 0 22 0 0 00 0 0 00 00 00 00 00 00 00 0 0 0 14 15 15 16 00 00 00 00 00 0 0 00 00 00 0 0 00 00 00 00 0 0 0 0 00 0 0 00 0 0 00 0 0 00 0 00 00 24 24 0 00 0 0 00 0 0 0 00 0 0 0 00 0 0 0 0 0 0 0 00 00 00 00 0 0 0 0 0 0 00 00 0 4 06 24 25 00 0 0 00 00 0 0 0 0 0 00 00 00 01 2 3 0 0 0 0 00 00 0 00 0 0 0 00 00 0 0 00 00 0 00 00 00 0 0 0 0 0 0 00 00 0 00 00 0 0 00 00 0 0 00 00 0 0 00 00 0 0 00 00 0 0 00 00 0 0 00 00 0 0 00 00 0 0 00 00 0 0 0 0 00 00 00 00 00 00 0 0 0 0 0 0 00 24 24 00 17 00 24 24 00 0 0 0 0 0 0 00 00 00 00 00 00 0 0 0 00 00 0 0 0 00 00 0 4 06 00 00 24 00 00 14 16 17 17 0 0 0 0 00 00 24 24 24 24 24 0 0 24 24 24 24 24 00 00 0 00 00 0 0 0 0 00 0 0 00 00 00 00 0 0 00 0 0 0 0 0 0 0 0 0 00 00 00 00 00 00 00 00 22 00 00 00 00 00 00 00 00 00 0 00 00 25 25 25 00 00 25 00 00 25 25 25 00 00 0 0 0 0 0 0 0 0 0 0 0 0 0 00 00 00 00
00 00 00 0 0 0 0 0 00 0 0 0 00 00 00 00 00 00 00 00 00 00 00 00 0 0 00 00 00 00 00 00 0 0 0 0 00 00 0 0 0 00 00 00 01 03 00 00 00 00 00 00 0 0 0 00 00 00 00 00 00 00 0 00 00 0 01 02 02 02 2 2 03 0 0 00 0 0 00 00 00 00 00 00 00 0 0 0 00 00 00 00 00 14 15 15 16 0 0 00 00 00 0 0 00 00 00 01 2 3 0 0 00 0 0 00 0 0 24 0 0 02 0 00 00 00 00 0 00 0 0 00 0 0 0 00 0 0 0 00 0 0 0 0 0 0 0 00 00 00 00 0 0 0 0 0 0 00 00 0 4 06 24 00 01 2 2 02 02 2 3 0 0 0 00 00 00 04 5 6 0 0 0 0 00 00 0 22 0 0 0 00 00 0 0 00 00 0 00 00 20 0 0 0 0 0 0 00 00 0 00 00 0 0 00 00 0 0 14 16 0 0 00 00 0 0 00 00 0 0 00 00 0 0 00 00 0 0 14 16 0 0 00 00 0 0 0 0 00 00 00 00 00 00 0 0 0 0 0 0 24 24 00 17 17 17 00 24 24 0 0 0 0 0 0 00 00 00 00 00 00 0 0 0 00 00 0 0 0 00 00 0 4 06 00 00 00 00 00 00 00 17 17 0 0 0 0 00 00 00 24 24 24 00 0 0 00 24 24 24 00 00 00 0 00 00 0 0 0 0 00 0 0 00 00 00 00 0 0 00 0 0 0 0 0 0 0 0 0 00 00 00 00 00 00 18 18 18 00 00 00 00 00 00 00 00 00 0 00 00 25 00 25 00 00 25 00 00 25 00 25 00 00 0 0 0 0 0 0 0 0 0 0 0 0 0 00 00 00 00
21 00 00 0 0 0 0 0 00 0 0 0 00 00 00 14 15 15 16 00 00 00 00 01 2 2 03 00 00 00 00 00 0 1 2 2 03 00 0 0 0 00 00 00 04 06 00 00 00 00 00 00 0 0 0 00 00 00 00 00 14 16 0 00 00 0 04 05 05 05 5 5 06 0 0 19 0 0 00 14 15 15 15 15 16 0 0 0 00 00 00 00 00 00 00 00 00 0 0 00 00 00 0 0 00 17 00 04 5 6 0 0 00 0 0 24 0 0 00 0 0 05 0 00 00 00 00 0 24 0 0 00 0 0 0 00 0 0 0 00 0 0 0 0 0 0 0 00 00 00 00 0 0 0 0 0 0 00 00 0 4 12 13 10 11 5 8 08 08 8 9 0 0 0 00 00 01 11 5 6 0 0 1 2 02 02 2 03 0 0 0 00 00 0 0 00 00 0 14 15 16 0 0 0 0 0 0 00 00 0 14 16 0 0 00 00 0 0 00 00 0 0 00 00 0 0 00 00 0 0 14 16 0 0 00 00 0 0 00 00 0 0 00 00 0 0 0 0 00 00 17 17 00 00 0 0 0 0 0 0 24 00 17 17 17 17 17 00 24 0 0 0 0 0 0 00 00 17 17 00 00 0 0 0 00 00 0 0 0 00 00 0 4 12 13 03 00 00 00 00 00 17 17 0 0 1 2 03 00 00 00 24 00 00 0 0 00 00 24 00 00 00 01 2 03 00 0 0 0 0 00 0 0 14 15 15 16 0 0 00 0 0 0 0 0 0 0 0 0 00 00 00 00 18 18 18 18 18 00 00 00 00 00 00 00 00 00 0 17 00 25 00 25 00 00 25 00 00 25 00 25 00 17 0 0 0 0 0 0 0 0 0 0 0 0 0 00 00 00 00
02 03 00 0 0 0 0 0 00 0 0 0 00 00 00 00 00 00 00 00 00 00 00 04 5 5 06 00 00 00 00 00 0 4 5 5 12 13 2 2 2 03 00 00 04 06 00 00 00 00 00 00 0 0 0 00 00 00 00 00 00 00 0 00 00 0 07 08 08 05 5 5 06 0 0 01 2 2 03 00 24 24 24 24 00 0 0 0 00 00 00 00 00 00 00 00 00 0 0 00 00 00 0 0 17 17 20 04 5 6 0 0 25 0 0 00 0 0 02 0 0 05 0 00 00 00 00 0 00 0 0 00 0 0 0 26 0 0 0 00 0 0 0 0 0 0 0 00 00 00 00 0 1 2 2 2 2 03 00 0 7 08 08 08 08 9 0 00 00 0 0 0 0 0 01 10 11 05 5 6 0 0 4 5 05 05 5 06 0 0 0 00 00 0 0 00 00 0 00 00 00 0 0 0 0 0 0 00 00 0 00 00 0 0 14 16 0 0 00 00 0 0 00 00 0 0 00 00 0 0 00 00 0 0 14 16 0 0 00 00 0 0 00 00 0 0 0 0 00 17 17 17 17 00 0 0 0 0 0 0 00 17 17 17 17 17 17 17 00 0 0 0 0 0 0 00 17 17 17 17 00 0 0 0 00 00 0 0 0 00 00 0 7 08 08 09 00 00 00 00 23 17 17 0 0 4 5 06 00 00 00 00 00 00 0 0 00 00 00 00 00 00 04 5 06 00 0 0 0 0 00 0 0 00 25 25 00 0 0 00 0 0 0 0 0 0 0 0 0 00 00 18 18 18 18 18 18 18 00 00 00 00 00 00 00 00 00 0 17 00 00 00 00 17 00 00 00 17 00 00 00 00 17 0 0 0 0 0 0 0 0 0 0 0 0 0 17 17 17 17
05 06 00 0 0 0 0 0 00 0 0 0 00 00 00 00 00 00 00 00 00 01 10 11 5 5 06 00 00 02 00 00 0 4 5 5 05 05 5 5 5 06 24 24 04 06 00 00 00 00 00 00 0 0 0 00 00 00 00 00 00 00 0 14 16 0 00 00 00 04 5 5 06 0 0 04 5 5 06 00 00 00 00 00 00 0 0 0 00 00 00 00 01 02 02 02 02 2 2 02 02 02 2 2 02 02 10 11 5 6 0 0 00 0 0 02 0 0 05 0 0 05 0 00 00 00 00 0 02 0 0 24 0 0 0 00 0 0 0 22 0 0 0 0 0 0 0 17 17 00 00 0 4 5 5 5 5 06 00 0 0 00 00 00 00 0 0 00 00 0 0 0 0 0 04 05 05 05 5 6 0 0 7 8 05 05 5 06 0 0 0 00 00 0 0 14 16 0 00 00 00 0 0 0 0 0 0 14 16 0 00 00 0 0 00 00 0 0 00 00 0 0 00 00 0 0 14 16 0 0 00 00 0 0 00 00 0 0 00 00 0 0 00 01 2 2 2 2 03 17 17 17 17 01 2 2 2 2 2 2 03 17 17 17 17 17 17 17 01 2 2 2 2 2 2 03 17 17 17 17 01 2 2 2 03 00 0 0 0 00 00 0 0 00 00 00 00 00 00 01 02 02 03 0 0 4 5 12 13 02 02 02 02 02 2 2 02 02 02 02 02 10 11 5 12 13 2 2 2 2 03 0 0 00 25 25 00 0 0 01 2 2 3 0 0 0 0 0 0 19 18 18 18 18 18 18 18 18 20 19 20 01 03 19 20 19 01 2 02 02 02 02 02 02 02 02 02 02 02 02 02 02 02 2 2 2 2 2 2 2 2 2 2 2 2 2 02 02 02 02
05 12 13 2 2 2 2 2 03 0 0 1 03 00 00 00 00 00 00 00 00 04 05 05 5 5 06 00 00 05 00 00 0 4 5 5 05 05 5 5 5 06 25 25 04 06 00 00 00 00 00 00 0 0 0 00 00 00 00 00 00 00 0 18 18 0 20 19 19 04 5 5 06 0 0 04 5 5 12 13 02 02 02 02 02 2 2 2 02 02 02 10 11 05 05 05 05 5 5 05 05 05 5 5 05 05 05 05 5 6 0 0 02 0 0 05 0 0 05 0 0 05 0 00 00 00 00 0 05 0 0 00 0 0 0 02 0 0 0 01 2 2 2 2 2 2 2 02 03 00 20 0 4 5 5 5 5 06 00 0 0 00 00 00 00 0 0 00 01 2 2 2 2 2 11 05 05 05 5 6 0 0 0 0 04 05 5 06 0 0 0 14 16 0 0 00 00 0 00 00 00 0 0 0 0 0 0 00 00 0 00 00 0 0 00 00 0 0 00 00 0 0 14 16 0 0 00 00 0 0 00 00 0 0 00 00 0 0 00 00 0 0 19 04 5 5 5 5 12 13 02 02 10 11 5 5 5 5 5 5 12 13 02 02 02 02 02 10 11 5 5 5 5 5 5 12 13 02 02 10 11 5 5 5 12 13 2 2 2 03 00 0 0 00 00 00 00 00 00 04 05 05 06 0 0 4 5 05 05 05 05 05 05 05 5 5 05 05 05 05 05 05 05 5 05 05 5 5 5 5 06 0 0 00 00 00 00 0 0 04 5 5 6 0 0 0 1 2 2 02 02 02 02 02 02 02 02 02 02 02 10 11 12 13 02 10 11 5 05 05 05 05 05 05 05 05 05 05 05 05 05 05 05 5 5 5 5 5 5 5 5 5 5 5 5 5 05 05 05 05
05 05 05 5 5 5 5 5 06 0 0 4 12 13 02 02 02 02 02 02 10 11 05 05 5 5 06 00 00 05 00 00 0 4 5 5 05 05 5 5 5 12 13 10 11 12 13 02 02 02 02 02 2 2 2 02 02 02 02 02 02 02 2 02 02 2 02 02 10 11 5 5 06 0 0 04 5 5 05 05 05 05 05 05 05 5 5 5 05 05 05 05 05 05 05 05 05 5 5 05 05 05 5 5 05 05 05 05 5 6 0 0 05 0 0 05 0 0 05 0 0 05 0 01 03 00 00 0 05 0 0 02 0 0 0 05 0 0 0 04 5 5 5 5 5 5 5 05 12 13 03 0 4 5 5 5 5 12 13 2 2 02 02 02 02 2 2 10 11 5 5 5 5 5 05 05 05 05 5 6 0 0 0 0 04 05 5 06 0 0 0 00 00 0 0 00 00 0 00 00 00 0 0 1 2 3 0 00 00 0 00 00 0 0 00 00 0 0 00 00 0 0 00 00 0 0 00 00 0 0 00 00 0 0 00 00 0 0 00 00 0 0 01 11 5 5 5 5 05 05 05 05 05 05 5 5 5 5 5 5 05 05 05 05 05 05 05 05 05 5 5 5 5 5 5 05 05 05 05 05 05 5 5 5 05 05 5 5 5 12 13 2 2 02 02 02 02 02 10 11 05 05 06 0 0 4 5 05 05 05 05 05 05 05 5 5 05 05 05 05 05 05 05 5 05 05 5 5 5 5 12 3 0 00 00 00 00 0 1 11 5 5 6 0 0 0 4 5 5 05 05 05 05 05 05 05 05 05 05 05 05 05 05 05 05 05 05 5 05 05 05 05 05 05 05 05 05 05 05 05 05 05 05 5 5 5 5 5 5 5 5 5 5 5 5 5 05 05 05 05
00 01 02 3 4 5 6 7 08 0 0 1 12 13 14 15 16 17 18 19 20 21 22 23 4 5 26 27 28 29 30 31 2 3 4 5 36 37 8 9 0 41 42 43 44 45 46 47 48 49 50 51 2 3 4 55 56 57 58 59 60 61 2 63 64 5 66 67 68 69 0 1 72 3 4 75 6 7 78 79 80 81 82 83 84 5 6 7 88 89 90 91 92 93 94 95 96 7 8 99 00 01 2 3 04 05 06 07 8 9 0 1 12 3 4 15 6 7 18 9 0 21 2 23 24 25 26 7 28 9 0 31 2 3 4 35 6 7 8 39 0 1 2 3 4 5 6 47 48 49 50 1 2 3 4 5 6 57 58 9 0 61 62 63 64 5 6 67 68 9 0 1 2 3 74 75 76 77 8 9 0 1 2 3 84 85 6 87 8 9 0 91 92 3 4 95 96 7 98 99 00 1 2 3 4 5 6 07 08 9 10 11 2 3 14 15 6 7 18 19 0 1 22 23 4 5 26 27 8 9 30 31 2 3 34 35 6 7 38 39 0 1 42 43 4 5 6 7 48 49 50 51 52 53 4 5 6 7 8 9 60 61 62 63 64 65 66 67 68 9 0 1 2 3 4 75 76 77 78 79 80 1 2 3 84 85 6 7 8 89 90 1 2 93 94 95 96 97 98 99 00 01 02 3 4 5 6 07 08 09 10 11 12 13 4 5 16 17 18 19 20 21 22 3 24 25 6 7 8 9 30 1 2 33 34 35 36 7 8 39 0 1 2 3 4 5 6 7 8 49 50 51 52 53 54 55 56 57 58 59 60 61 62 63 64 65 66 7 68 69 70 71 72 73 74 75 76 77 78 79 80 81 82 3 4 5 6 7 8 9 0 1 2 3 4 5 06 07 08 09